eš₁₀	e₄
duru₅	dur₅
emₓ	e₄
ea	e₄
aia	ai
am₃	a₄
šeŋ₃	še₇
šeg₃	še₇
šemₓ	še₇
erua	eru₄
erum₄	eru₄
ummudₓ	ummuₓ
ummudₓ	ummu₃
kuara₂	kuar₂
girima₃	girim₃
šešₓ	šeₓ
ira₂	ir₂
era₂	er₂
idₓ	iₓ
itu₅	it₂
ida₂	id₂
id₂	i₇
it₂	i₇
iti₅	it₂
ita₅	it₂
eduru	edur
saha₇	sah₇
zaha₃	zah₃
amuša	amuš
a₂⁻	a₂
ahi₂	ah₅
te₈⁻	te₈
ah₅	a₂
idi₂	id
lirum₅	liru₅
lirum₄	liru₄
ʾa	ʾ
ʾe	ʾ
ʾi	ʾ
ʾu	ʾ
eša₃	eš₃
esa₃	es₃
ešeₓ	eš₃
aba	ab
zabalam₆	zabala₆
siraran	sirara
unugₓ	unuₓ
gunuₓ	gunₓ
unug	unu
unu⁻	unu
guna₄	gun₄
aba₄	ab₄
erin₅	eri₁₁
unug⁻	unug
gunu₄	gun₄
erim₅	eri₁₁
liti	lit
lid	li₈
lit	li₈
let	le₈
liṭ	li₈
rimu₂	rim₂
reme₂	rem₂
liṭi	liṭ
unud	unu₃
kiri₉	kir₂
uba₅	ub₅
ada	ad
aba₃	ab₃
aq	a₅
akiₓ	ak
aka	ak
ak	a₅
aqa	aq
kid₃	ki₃
ag	a₅
ala₃	al
maha₂	mah₂
marad	mara₂
mara₂	mar₂
ṣuru	ṣur
dinir	dir₃
ilu	il₃
dimer	dir₃
digir	dir₃
anu	an
dingira	dingir
sagₓ	sa₈
diŋir	dir₃
ana₂	an
ili	il₃
diner	dir₃
dibur	dir₃
dimir	dir₃
ila	il₃
anzud	anzu
anzud₂	anzu₂
niggin	niggi
anše⁻	anše
duru₃	dur₃
dur₃	du₂₅
mulu	mul
uru₄	ur₁₁
engara	engar
apina	apin
eru	er₃
eri₃	er₃
erum	eru
nintah₂	ninta₂
nitah₂	nita₂
santag	santa
lirum₂	liru₂
dele	del
aša	aš
deli	del
rum	ru₃
santak	santa
ina	in₆
dili	dil
imina₃	imin₃
dili₄	dil₄
santak₃	santa₃
dele₄	del₄
santag₃	santa₃
ṣibi	ṣib
asa₂	as₂
aša₂	aš₂
utu₅	ut₂
zara₅	zar₅
paṭ₂	paₓ
med	me₄
pet₂	pe₃
bat	ba₉
bata	bat
pad₂	paₓ
bad	ba₉
pit₂	pi₃
bit₂	bi₄
pat₂	paₓ
baṭ	ba₉
baragₓ	bara₄
bada	bad
met	me₄
mitu	mit
bid₂	bi₄
miti	mit
pid₂	pi₃
zara₆	zar₆
buruₓ	burₓ
aluraₓ	alurₓ
pala₄	pal
balak	bala
bala	bal
gudu₁₀	gud₁₀
bare	bar
bar	ba₁₅
para₂	par₂
bara	bar
parag	para₁₀
šara	šar₆
barag	bara₂
šar₆	ša₂₃
bara₂	bar₂
biz	bi
šaqum	šaqu
bappira₃	bappir₃
git₂	gi₂₇
sugₓ	su₁₃
giṭ₂	gi₂₇
gidi₃	gid₂
ildumₓ	ilduₓ
surₓ	su₁₃
suš₃	su₁₃
gid₂	gi₂₇
gidim₃	gidi₃
gida₂	gid₂
sud₄	su₁₃
gim₇	gi₂₇
sir₂	siₓ
bur₁₂	bu
magara	magar
buru	bur
puru	pur
sun₅	su₁₆
ušum	ušu
buru₂	bur₂
dun₅	du₉
bul₂	bu₈
bur₂	bu₈
buru₅	bur₅
bara₃	bar₃
barag₂	bara₃
dak	da₈
daq	da₈
dag	da₈
haru₄	harₓ
hara₄	harₓ
akani	akan
kisim₄	kisiₓ
lahtan₆	lahta₆
amaša	amaš
haruba	harub
dama	dam
tam₂	ta₄
dam	da₄
ṭam	ṭa₄
dar	daₓ
gunu₃	gun₃
dara₆	dar
gun₃	guₓ
tarah	tara₃
dara₃	dar₃
tara₃	tar₃
tarahₓ	tara₄
dara₄	dar₄
ganam₆	gana₆
ua₂	u₁₀
sim₃	si₈
sal₂	sa₂
silima	silim
silim	siliₓ
dip	diₓ
dibi	dib
dib	diₓ
dabe	dab
daba	dab
tim	ti₃
dim	di₁₁
munu	mun
dima₂	dim₂
mušdam	mušda
šidim	šidi
gim	gi₁₈
gen₇	ge₁₈
gin₇	gi₁₈
kem	ke₅
kim	ki₅
gem	ge₁₈
dim₂	diₓ
mušdama	mušdam
gimi	gim
kin₈	ki₅
tim₃	ti₂
din	di₂
tin	ti₂
dini	din
ili₆	il₄
ana	anₓ
santak₄	santa₄
diša	diš
santag₄	santa₄
eša₅	eš₅
kurₓ	kuₓ
ginaₓ	gin
kup	kuₓ
guba	gub
gubu	gub
kub	kuₓ
tumu₂	tum₂
tuma₂	tum₂
dulₓ	du
tum₂	tu₃
laha₅	lah₅
lalah₂	lah₅
ereₓ	erₓ
sugₓ	suₓ
subₓ	suₓ
lalahₓ	lahₓ
rige₁₂	rig₁₂
laha₄	lah₄
sug₂	su₈
sub₂	su₈
lalah	lah₄
subₓ	suₓ
sugₓ	suₓ
suhuš⁻	suhuš
giri₆	gir₆
girim₂	giri₅
giri₅	gir₅
barim⁻	barim
kas₄	ka₇
kamaš	kaš₄
kaš₄	ka₇
im₂⁻	im₂
gir₅⁻	gir₅
kaš₄⁻	kaš₄
gana₃	gan₃
subₓ	suₓ
sugₓ	suₓ
dehi	deh
duba	dub
dubu	dub
urudu₂	urud₂
duba₂	dub₂
dubu₂	dub₂
duka	duk
lumu₃	lum₃
lutu	lut
luṭu	luṭ
dugud	duguₓ
duguda	dugud
duh	du₈
duru₉	dur₉
šaha₂	šah₂
duna	dun
šahan₃	šaha₂
sul	su₁₇
dun	du₂₄
dur₉	du₂₄
tun₃⁺	tun₃
du₅⁺	du₅
tun₃	tu₁₈
dug₅	du₅
tug₈	tu₁₈
dun₃⁺	dun₃
dulₓ	du₅
tuna₃	tun₃
sug₅	su₁₈
dun₃	du₅
gina₂	gin₂
miri	mir
migir	mir
mere	mer
duru₂	dur₂
durun	duru₂
duruna	durun
durum₂	duru₂
eg₂	e
guru₂₁	gur₂₁
kurul₁₄	kuru₁₄
kuru₁₄	kur₁₄
biti	bit
aʾ₃	a₁₄
betu	bet
bitu	bit
eʾ₃	e₂
agrunaₓ	agrun
agrun	agruₓ
araha	arah₄
edena	eden
edina	edin
erua₂	eru₅
egera	eger
eŋera	eŋer
ili₅	il₅
ele₂	el
uru₁₆	urₓ
urunₓ	uru₁₆
eni	en
enu	en
ena	en
enegir₃	enegi₃
suena	suen
zuena	zuen
mermeri₂	mermer₂
merimeri₂	merimer₂
buru₁₄	bur₁₄
eburuₓ	ebur
enkara	enkar
merimeri	merimer
mermeri	mermer
erena	eren
šeš₄	še₂₂
erina	erin
erena₂	eren₂
rina₂	rin₂
erina₂	erin₂
ṣapa	ṣap
uba₂	ub₂
egir₂	egi
eger₂	ege
ger₁₅	ge₇
ŋer₁₅	ŋe₇
ŋir₁₅	ŋi₇
gir₁₅	gi₇
eše₂	eš₂
karaₓ	karₓ
guruₓ	gurₓ
zid₂	zi₃
ezena	ezen
asilalₓ	asilaₓ
ezema	ezem
asilaₓ	asilₓ
silal	sil₆
asilal₃	asila₃
asila₃	asil₃
asila₅	asil₅
asilal₅	asila₅
asila₄	asil₄
asilal₄	asila₄
bat₃	ba₈
ug₅	u₉
bad₃	ba₈
un₃	u₉
uk₅	u₉
bada₃	bad₃
ubₓ	u₉
uŋ₅	u₉
uga₅	ug₅
dugina	dugin
dugina₂	dugin₂
ubara	ubar
kisiga	kisig
gubalaga	gubalag
asilal	asila
asila⁻	asila
asila	asil
asila₆	asil₆
asilal₆	asila₆
gar₉	ga
gara₉	gar₉
gara₁₁	gar₁₁
garaš₃	garaₓ
gara₁₀	gar₁₀
gara₂	gar₂
mala	mal
mal	ma₃
dagala	dagal
sabad₂	sad₃
gagia₂	gagi₂
gagia	gagi
išhurum₅	išhuru₅
menaₓ	men
min₇	mi₄
itima	itim
ura₃	ur₃
uru₁₂	ur₃
išhuru₄	išhur₄
ami₂	am₅
ame₂	am₅
ama₅	am₅
sabad₃	sad₄
sabad	sad₂
ṭuh	ṭu₅
gaba	gab
gada	gad
gadu	gad
gala₈	gal
gale	gal
santana	santan
šandana	šandan
tirum	tiru
sukud	sukuₓ
guru₂	gur₂
gurum	guru₂
saga₇	sag₇
kana	kan
gana	gan
išhurum₃	išhuru₃
kana₂	kan₂
ašag	aša₅
gana₂	gan₂
kara₂	kar₂
guru₆	gur₆
nindanaₓ	nindan
gara	gar
gar	ga₄
niqiₓ	niq₂
niŋdanaₓ	niŋdanₓ
nig₂	ni₃
niq₂	ni₃
nindan	ninda
niŋ₂	ni₃
nik₂	ni₃
garak₅	gara
nin₆	ni₃
nim₅	ni₃
nigiₓ	nig₂
gara₃	gar₃
ugunu₂	ugun₂
ŋeština	ŋeštin
geština	geštin
sig₁₇	si₂₂
gen₆	ge
gin₆	gi
taru₅	tar₅
gib	gi₁₆
gili	gil
gilim	gili
gilibₓ	gili
gil	gi₁₆
gel	ge₁₆
gib₃	gi₁₇
geg	ge₁₇
gig	gi₁₇
ŋiri₂	ŋir₂
giri₂	gir₂
meri₃	mer₃
kišik₂	kiši₁₇
kišig₂	kiši₁₇
giru₃	gir₃
ŋiri₃	ŋir₃
giri₃	gir₃
šaggina	šaggin
alim⁻	alim
alima	alim
girid₂	giri₁₆
giri₁₆⁻	giri₁₆
giri₁₆	gir₁₆
lulima	lulim
giša	giš
ŋessun	ŋessu
ŋištug₃	ŋištu₃
gištug₃	gištu₃
ŋeštug₃	ŋeštu₃
geštug₃	geštu₃
geštug₂	geštu₂
ŋištug₂	ŋištu₂
gištug₂	gištu₂
ŋeštug₂	ŋeštu₂
lirum₃	liru₃
duru₄	dur₄
durum₄	duru₄
guru₁₇	gur₁₇
sah₄	saₓ
gun₂	gu₂
ṭuru	ṭur
usan₂	usaₓ
gudu	gud
gara₄	gar₄
gud	gu₄
dapara	dapar
gurₓ	gu₄
ama₂	am
gulu	gul
sumunu₂	sumun₂
sumuna₂	sumun₂
isim₂	isi₂
sumun₂	sun₂
suna₂	sun₂
isimu₂	isim₂
gum	gu₈
naŋa₄	naŋ₄
kum	ku₁₃
qum	qu
gaz⁻	gaz₂
naga₄	nag₄
kun₃	ku₁₃
naga₃	nag₃
gaza	gaz
naŋa₃	naŋ₃
guru	gur
gura	gur
quru	qur
guru₇	gur₇
gurumₓ	guru₂₀
gurun	guru₂₀
buru₇	bur₇
kua	ku₆
ha⁺	ha
kuara	kuar
zaha₂	zah₂
saha₆	sah₆
peš⁻	peš
kir⁻	kir
gir⁻	gir
piša	piš
kiri	kir
qiri	qir
ŋiri	ŋir
giri	gir
buru₈	bur₈
hala	hal
buruh	buru₈
dugu	dug₃
danₓ	da₁₀
dab₃	da₁₀
dub₃	du₁₀
ṭab₆	ṭa₃
dug₃	du₁₀
hušuₓ	huš
huša	huš
huš⁻	huš
huru	hur
hir₂	hiₓ
murum	muru
ura₅	ur₅
hara	har
uruₓ	ur₅
ara₃	ar₃
hur	hu₄
muru	mur
kam	ka₁₃
kama	kam
šargadu	šargad
aha	ah
uh	u₁₃
uhu	uh
gudug	gudu₄
biri	bir
mušena	mušen
mut	mu₁₂
muṭ	mu₁₂
mud	mu₁₂
tumₓ	tu₁₁
tu₁₁⁺	tu₁₁
tukuₓ	tukₓ
tukₓ	tu₁₁
tun₂	tu₁₁
tumₓ	tu₁₀
tun	tu₁₀
hula₂	hul₂
darum₂	daru₂
dari₂	dar₂
daru₂	dar₂
dara₂	dar₂
buruₓ	burₓ
buru₉	burₓ
buruₓ	burₓ
gala₇	gal₂
gal₂	ga₇
pan₃	pa₁₀
limi	lim
lib₄	li₃
badi	bad₅
lem	le₃
pad₄	pa₁₀
lim	li₃
lima	lim
ug₆	u₆
burumₓ	buruₓ
saga₁₀	sag₁₀
kurum₇	kuru₇
sag₁₀	sa₁₃
gurum₂	guruₓ
kuru₇	kur₇
ildum	ildu
ilduma	ildum
ubrim	ubri
ilduma₂	ildum₂
ildum₂	ildu₂
ara₈	ar
pad₃	pa₃
ligima	ligim
hula	hul
hulu	hul
sag₁₂	sa₇
samag₆	sag₁₂
sig₇	si₁₂
seg₇	se₁₂
ila₂	il₂
ili₂	il₂
gaŋₓ	ga₆
guru₃	gur₃
imeₓ	im
tumu	tum₉
tum₉	tu₁₅
muru₃	mur₃
enegir	enegi
karkara	karkar
šara₅	šar₅
imi	im
ulubar	uluba
ulubar₂	uluba₂
merimeri₄	merimer₄
mermeri₄	mermer₄
mermeri₃	mermer₃
merimeri₃	merimer₃
umunaₓ	umun₇
imina	imin
ini	in
ereš₃	ere₁₄
iri₁₄	ir
ire₁₄	ir
eri₁₄	er
ere₁₄	er
isiš	isi
iši	iš
isi	is₂
mili	mil
dag₅	da₁₂
kag₂	ka
sumₓ	su₁₁
zuh	zu₂
kiri₃	kir₄
dug₄	du₁₁
sumurₓ	sumuₓ
zug₂	zu₂
duga₄	dug₄
iš₅	i₅
en₄	e₇
gur₁₈	gu₃
sugₓ	su₁₁
kak₂	ka
sumuₓ	sumₓ
giri₁₇	gir₁₇
šuduₓ	šudₓ
nag	na₈
naga₂	nag
nak	na₈
naq	na₈
namₓ	na₈
naŋ	na₈
šeg₁₁	še₂₆
še₂₆⁻	še₂₆
šidₓ	šiₓ
šed₁₅	še₂₆
šigₓ	šiₓ
kana₆	kan₆
bum	bu₃
pum	pu₃
buzur₅	burₓ
burₓ	bu₃
gu₇⁻	gu₇
bun₂	bu₁₃
buhₓ	bu₁₃
sulₓ	suₓ
sumₓ	suₓ
sunₓ	suₓ
munₓ	mu₇
mele₂	mel₂
meli₂	mel₂
mumunₓ	munₓ
gilib₃	gili₃
eme	em₄
nundum	nundu
numdun	numdu
nundun	nundu
numdum	numdu
sum₄	su₆
sul₃	su₆
sun₄	su₆
tukureₓ	tukur₂
šed₁₄	še₂₅
silig₆	sigₓ
šilig₆	šigₓ
šeg₁₀	še₂₅
šud₃	šu₁₂
šedₓ	šeₓ
šegₓ	šeₓ
šudu₃	šud₃
kan₄	ka₂
akan₂	aka₄
babilima	babilim
babilima₂	babilim₂
abula	abul
gabu₂	gab₂
kapa	kap
gaba₂	gab₂
gubu₃	gub₃
kata₃	kat₃
kal₃	ka₁₅
kaq	ka₁₅
kak	ka₁₅
qaq	qa₆
lab	la₆
sunaₓ	sun₇
lammar	lamma
sig₁₅	si₂₁
sag₈	sa₁₄
kalaga	kalag
kalag	kala
lamar	lama₃
kala	kal
tana	tan
esig	esi
lap	la₆
silima₂	silim₂
dana₃	dan
lirum₇	liru₇
kasa	kas
buš	bu₂
šubtum₃	šubtu₃
šubtum₅	šubtu₅
šubtum₆	šubtu₆
šubtum₇	šubtu₇
šubtum₄	šubtu₄
kirid	kiri₇
kiris	kiri₇
kirit	kiri₇
girid	giri₁₁
kiši₂	kiš₂
giri₁₁	gir₁₁
keše₂	keš₂
keši₂	keš₂
šakira₂	šakirₓ
murum₆	muru₆
buru₁₁	bur₁₁
muru₆	mur₆
meli	mel₃
habruda₂	habrud₂
habruda	habrud
buru₆	bur₆
ket	ke₄
qit	qi₅
git	gi₂
lila₂	lil₂
kid	ki₄
kiṭ	ki₄
gid	gi₂
qid	qi₅
kit	ki₄
saga₁₁	sag₁₁
siga₁₈	sig₁₈
qin	qi
kiši	kiš
keše	keš
kiše	kiš
bulₓ	bu₇
guz₃	gu₅
bid₃	bi₇
bed₃	be₅
gud₇	gu₅
sur₁₁	su₅
suš	su₅
bet₃	be₅
daba₅	dab₅
tukula	tukul
šed₆	še₁₀
tušu	tuš
bit₃	bi₇
suh₅	su₅
kud₃	ku
durunaₓ	durunₓ
mermeri₅	mermer₅
merimeri₅	merimer₅
kug	ku₃
kuk	ku₃
azak	aza₂
azag	aza₂
asag	asaₓ
kur₉	ku₄
kuruš	kuš₆
kud₅	ku₇
kuš₆	ku₇
kul	ku₉
zaraₓ	zar₄
ziri	zir
kulu	kul
numun	numu
gul₂	gu₉
kula	kul
kun	ku₁₄
kuŋ₂	ku₁₄
kunu	kun
gina₃	gin₃
šata	šat
sata	sat
nata	nat
šada	šad
lata	lat
šadi	šad
ramanu	raman
šadu	šad
kušu₂	kuš₉
šika	šikₓ
nimen₂	nin₄
girim	giri₈
ellag	ella₂
kuru₄	kur₄
giri₈	gir₈
kili	kil
niŋen₂	nin₄
ellaŋ	ella₂
rem	re₃
nigin₂	nigi₂
haba	hab
nin₄	ni₁₀
kele	kel
tukulₓ	tuku₆
rin	ri₃
niŋin₂	niŋi₂
gili₂	gil₂
rim	ri₃
kur₄	kuₓ
surₓ	suₓ
kilib	kili
girin	giri₈
tukur	tuku₆
reme	rem
niŋin	nin₃
nini	nin₃
kilib₃	kili₃
kiluₓ	kil₃
nimenₓ	nin₃
kilaₓ	kil₃
niŋen	nin₃
kili₃	kil₃
nigin	nigi
nin₃	ni₆
abbaraₓ	abbar
as₄	a₉
idₓ	iₓ
sugiₓ	sug
ambara	ambar
gigira	gigir
siduga₂	sidug₂
dilina₃	dilin₃
delena₃	delen₃
ganam₅	gana₅
šurun₃	šuru₃
šurum₃	šuru₃
uz₅	u₈
ua	u₈
šurum	šuru
šurun	šuru
us₅	u₈
ganam₄	gana₄
lahrum	lahru
id₃	i₈
zikumuₓ	zikum
tinuru	tinur
delena	delen
dilina	dilin
ṣara	ṣar
zara	zar
bul₅	bu₁₄
šuš₅	šu₅
šuš₆	šu₆
šurun₂	šuru₂
gigira₂	gigir₂
burₓ	bu₄
bul	bu₅
tug₄	tu₁₃
ninnim₄	ninni₄
bur₁₀	bu₅
tuk₄	tu₁₃
buruₓ	bur₁₀
tuku₄	tuk₄
sul₄	su₇
sur₁₂	su₇
sura₁₂	sur₁₂
sug₈	su₇
tul₅	tu₂₁
dul₆	du₆
ed₃	e₁₁
ed₄	e₁₂
karaₓ	karₓ
suru₅	sur₅
šuruₓ	šurₓ
lal	la₂
zuru₅	zur₅
lal₂	la₅
lallal	lalla
ukur₄	uku₅
halpiaₓ	halpiₓ
halpia	halpi
ukur₃	uku₂
lam	la₁₂
lama	lam
ešuₓ	eš₂₂
kurₓ	kuₓ
limu₂	lim₂
dilim₂	dili₂
liz	li₁₂
lis	li₁₂
liš	li₁₂
lug	lu
gala₁₀	gal₁₀
adaₓ	ad₆
ereₓ	erₓ
ešelal	ešela
eri₁₃	er₁₃
ere₁₃	er₁₃
hara₃	har₃
ereₓ	erₓ
rin₅	ri₉
lugala	lugal
šarrum	šarru
šaraₓ	šar₃
luhu	luh
lugₓ	lu₅
libi	lib
lup	lu₅
lulu	lul
lul	lu₅
nari	nar
lub	lu₅
guz	gu₁₅
luma	lum
lumu	lum
gum₂	gu₁₅
hum	hu₅
humu	hum
gun₅	gu₁₅
gud₆	gu₁₅
hus	hu₅
lum	lu₄
num₂	nu₄
gumu	gum₂
dilur	dilu
sura₁₀	sur₁₀
maha	mah
mara	mar
maṣ	ma₇
mas	ma₇
maš	ma₇
meš₂	me
galₓ	gaₓ
men₂	me
mesi	mes
geg₂	ge₆
mušu	muš₉
muši	muš₉
gigi₂	gig₂
gig₂	gi₆
kukkug₂	kukku₂
mina	min
muhaldima	muhaldim
šum₃	šu₁₀
ia₅	i₁₄
šumu	šum₃
muštug₂	muštu₂
taha	tah
muga	mug
muguₓ	mug
muru₂	mur₂
murub₄	muru₂
muri	mur₂
suhₓ	suₓ
rin₄	ri₈
sed₆	se₂₇
sukuš	suku₆
sedi₆	sed₆
šed₁₂	še₂₃
sukud₃	suku₆
zabalam₅	zabala₅
zabalam₃	zabala₃
sedi₄	sed₄
šed₁₀	še₁₇
sed₄	se₂₅
šušina	šušin
susina	susin
šušinak	šušina
subi₃	subₓ
suba₃	subₓ
zabalam₄	zabala₄
sed₇	se₂₈
suz	su₁₀
suh	su₁₀
sukud₂	suku₅
sus	su₁₀
šed₁₃	še₂₄
sedi₇	sed₇
nad₃	na₂
nud	nu₂
nagara	nagar
ildum₃	ildu₃
ilduma₃	ildum₃
sin₂	si₁₃
sim	si₁₃
nam	na₇
lama₂	lam₂
bir₉	bi₂
šemₓ	še₆
pil	pi₅
šeg₆	še₆
kum₂	ku₁₆
gir₁₀	gi₉
bel	be₇
baraₓ	bar₇
lim₄	li₉
kun₉	ku₁₆
pel	pe₅
gibil⁻	gibil₄
bil	bi₂
lem₄	le₉
šeŋ₆	še₆
bili	bil
bila	bil
gira₃	gir₁₈
erima₂	erim₂
rim₃	riₓ
lisin	lisi
entena	enten
bil₂	bi₅
gibila	gibil
ia₃	i₃
libₓ	li₂
digi	dig
zala	zal
lid₂	li₂
dilmuna	dilmun
ia₄	i₄
tumu₄	tum₄
num	nu₃
tum₄	tu₈
nima	nim
dihi₃	dih₃
elamu	elam
nim	ni₇
elama	elam
dehi₃	deh₃
tum₃	tu₂₅
tum₃⁻	tum₃
tumu₃	tum₃
san₃	saₓ
samₓ	saₓ
rama	ram
aga₂	ag₂
sam₂	sa₁₀
murum₁₁	muru₁₁
ugudili	ugudil
uru₆	ur₇
urum	uru₆
ubudili	ubudil
zaŋ₃	zaₓ
zag₃	zaₓ
sag₅	saₓ
saŋ₅	saₓ
numₓ	nu₁₁
nurₓ	nu₁₁
buru₄	bur₄
lagasa	lagas
lagaša	lagaš
nunun	nun
nuŋₓ	nu₆
eridug	eridu
nuna	nun
nun	nu₆
eriduga	eridug
gara₆	gar₆
šilam⁻	šilam
šilam	šilaₓ
ninir	nir
naraₓ	nar₃
nenerₓ	ner
nira	nir
lirum₆	liru₆
guru₁₉	gur₁₉
kurud	kuru₁₁
guruda	gurud
kuru₁₁	kur₁₁
kuruda	kurud
gurud	guru₁₉
nunuz	nunu
nunus	nunu
lahtan	lahtaₓ
sig₃	si₂₉
lug₂	lu₉
luŋ₂	lu₉
hata	hat
mua	mu₆
lun	lu₉
ririg	rig₁₀
sipa₂	sip₄
šaba	šab
saba	sab
sibad	siba
siba	sib₂
sipad	sipa
sipa	sip₂
isina	isin
ensik	ensi₂
duduₓ	dud
tudu	tud₂
duda	dud
pata	pat
šutug	šug
pada	pad
šukur₂	šuku
šukun₃	šuku
šuku	šuk
pat	paₓ
pad	paₓ
paṭ	paₓ
ninnim₇	ninni₇
ninnimₓ	ninniₓ
bana	ban
pana	pan
pap	pa₄
pab	pa₄
kuru₂	kur₂
bap	ba₁₄
bab	ba₁₄
pad₅	pa₅
pad₆	pa₆
bur₁₃	bu₁₀
isimud	isimu
isimud₄	isimu₄
kiši₅	kiš₅
kišib₂	kiši₅
iu₂	i₁₆
gištug	gištu
tala₂	tal₂
ŋeštug	ŋeštu
ia₈	i₁₆
uw	u₁₇
uštug	uštu
ŋištug	ŋištu
ew	eₓ
muštug	muštu
am₇	a₃
geštug	geštu
iw	i₁₆
aw	a₃
tal₂	ta₇
piriŋ⁺	piriŋ
piriga	pirig
niskum	nisku
piriŋa	piriŋ
uku₄	uk
ug	u₂₁
uk	u₂₁
ug⁻	ug
udₓ	u₂₁
uq	u₂₁
asa	as
az⁻	az
aza	az
tidanum	tidanu
didanum	didanu
tidnum	tidnu
didnum	didnu
rah₂	ra
raba	rab
degₓ	de₅
rig₅	ri
dala	dal
tala	tal
illuru	illur
šuba₅	šub
šup	šuₓ
šub	šuₓ
šaq	ša₂₄
saŋa	saŋ
šag	ša₂₄
saŋ	sa₁₂
sag	sa₁₂
saq	sa₁₂
san	sa₁₂
samₓ	sa₁₂
šak	ša₂₄
sak	sa₁₂
erum₂	eru₂
urum₃	uru₁₀
kana₃	kan₃
erum₃	eru₃
guda₃	gud₂
gudu₂	gud₂
kuš₂⁻	kuš₂
dil₂⁻	dil₂
sumur⁻	sumur
šur₂⁻	šur₂
kušu₄	kuš₂
sumur	sur₂
sur₂⁻	sur₂
keše₄	keš₄
sala	sal
min₂	mi₂
mug₂	mu₁₀
mim	mi₂
mem	meₓ
muk₀	mu₁₀
šal	ša₁₂
egir₃	egi₂
eger₃	ege₂
gim₃	gi₁₂
geme₂	gem₃
gin₅	gi₁₂
gem₃	ge₁₂
kušuₓ	kušₓ
nina₃	nin
murub₅	muru₅
murum₅	muru₅
ŋeštana₄	ŋeštan₄
nitah₃	nita₃
ŋešdana₄	ŋešdan₄
ŋeštana	ŋeštan
ŋešdana	ŋešdan
sara	sar
šakar	šar
šar	ša₈
nisig	nisi
sariₓ	sar
sakar	sar
mud₆	mu₂
sahar₂	sar
šara₇	šar
sig₁₉	si₁₅
sig₉	si
seg₉	se
dirig	diri
diri	dir
šiq	ši₃
seg	se₁₁
sig	si₁₁
šik	ši₃
sik	si₁₁
siq	si₁₁
šig	ši₃
siga	sig
sek	se₁₁
šeŋ	šeₓ
šed₁₆	še₂₇
šeb₄	še₂₇
šeg₁₂	še₂₇
gara₈	gar₈
siki	sik₂
usₓ	uₓ
ganamₓ	ganaₓ
mudrum₄	mudru₄
šurumₓ	šuruₓ
šurunₓ	šuruₓ
zulumhi⁻	zulumhi
sila₃	sil₃
sala₄	sal₄
sum₃	su
sug₆	su
sir	siₓ
šut	šuₓ
sud	su₃
šuṭ	šuₓ
šud	šuₓ
sug₄	su₃
su₃⁻	su₃
šuz	šuₓ
sud⁻	sud
raṭ	ra₄
rat	ra₄
šitan	šita₃
rata	rat
rad	ra₄
sim₂	si₃
sig₁₀	si₃
seg₁₀	se₃
sik₁₀	si₃
sum	su₁₂
sumu	sum
šumu₂	šum₂
sun₃	su₁₂
gudug₂	gudu₁₁
sura	sur
sura₉	sur₉
šag₄	ša₃
šab₂	ša₃
habruda₃	habrud₃
habruda₄	habrud₄
sag₉	sa₆
šag₅	ša₆
sare₂	sar₂
sara₂	sar₂
šara₆	šar₂
nigan	niga
niga	nigₓ
nigu	nigₓ
uzu₃	uz
uza	uz
ezinam₃	ezina₃
ašnana	ašnan
ezinu₂	ezin₂
ezina₂	ezin₂
ezinan₂	ezina₂
ezinam₂	ezina₂
šega₉	šeg₉
ruqu	ruq
zahₓ	zaₓ
aha₂	ah₂
ahi	ah₂
šeš	še₁₆
šes	še₁₆
uram₂	ura₁₆
urum₆	uru₁₅
urim₅	uri₅
urum₅	uru₁₄
urim₂	uri₂
uram	ura₁₅
dugₓ	duₓ
šeš₂	še₈
lak	la₁₀
kas₇	ka₉
šita₅	šit
silag	sila₁₁
lag	la₁₀
aka₃	ak₃
laq	la₁₀
šed	še₁₄
saŋa₈	saŋ₅
laka	lak
silaŋ	sila₁₁
šet	še₁₄
zandara	zandar
giri₁₃	gir₁₃
šitim₂	šiti
šiti	šit
alal	alaₓ
asilal₂	asila₂
bappira₂	bappir₂
šim	ši₆
šembizid	šembizi
bappira	bappir
šembi⁻	šembi
sirum	siru
siru	sir₄
šeri	šer
qata	qat
šukud₂	šuku₂
lirum	liru
dilina₂	dilin₂
duruna₃	durun₃
delena₂	delen₂
qat₂	qa₄
qad₂	qa₄
šuš₂	šu₂
keši₃	keš₃
šudulu	šudul
šaha	šah
šubura	šubur
dapa₂	dap₂
taba	tab
tapa	tap
imina₂	imin₂
buruₓ	burₓ
sum₆	suₓ
šum	šu₁₄
taga	tag
taka	tak
tak	ta₃
šuš₄	šu₁₄
tag	ta₃
subu	sub₆
suhₓ	suₓ
šumu₃	šum
taq	ta₃
sub₆	suₓ
tag₄	ta₆
dat	da₁₃
taka₄	tak₄
tak₄	ta₆
tad	ta₆
šurum₆	šuru₆
tat	ta₆
dad	da₁₃
sila	sil
kud	ku₅
tar	taₓ
kur₅	ku₅
tara	tar
kurum₅	kuru₅
kuru₅	kur₅
kutu	kut
qutu	qut
sil	siₓ
kut	ku₅
temₓ	te
teg₃	te
temen	ten
ten	te
teŋ₃	te
kara	kar
kar	ka₁₁
unug₃	unu₆
unug₂	unu₂
unu₂	unₓ
guru₈	gur₈
maru⁻	maru
uru₅	ur₁₂
gura₈	gur₈
unug₄	unu₇
tel₃	te₉
til₃	ti
tig₄	ti
tila₃	til₃
tiŋ₄	ti
teŋ₄	te₉
suna	sun
sumun	sun
tur₅	tu
kurₓ	kuₓ
tud	tu
tum₁₂	tu
dud₂	du₂
dur₁₁	du₂
tug₂	tu₉
tuk₂	tu₉
mur₁₀	mu₄
tuku₂	tuk₂
tiškarini	tiškarin
tuq	tu₁₂
tuku	tuk
tuk	tu₁₂
tug	tu₁₂
duk₂	du₁₂
dum	du₄
tum	tu₄
ṭum	ṭu₄
dumₓ	du₁₃
dumu	dumₓ
turu	tur
tura	tur
ginan	gina
genan	gena
un₂	u
burudₓ	buru₃
buzur	bur₃
bur₃	bu₁₂
buru₃	bur₃
šuš	šu₄
kiriₓ	kir₁₃
isimu₃	isim₃
isim₃	isi₃
utu₂	ut₆
ulu	ul
ula	ul
ugun₃	ugu
kušum₄	kušu
kušu	kuš₅
bakirum	bakiru
mam	ma₁₀
mana	man
man	ma₁₀
mina₃	min₃
ušu₃	uš₁₈
eše	eš
eša₂	eš
nig₆	ni₉
niŋ₆	ni₉
kazabur	kazabu
kazabu	kazab
kiša	kiš₁₆
kiši₁₆	kiš₁₆
kišik	kiši₁₆
kišig	kiši₁₆
ara₂	ar₂
ubu₂	ub
uba	ub
para	par
tam	ta₅
uṭ	u₄
dadagₓ	dag₂
uta	ut
ug₄	u₄
zalag	zalaₓ
zalah	zalaₓ
dag₂	da₇
šarag	šara₉
hada₂	had₂
ud	u₄
dam₂	da₇
al₅	a₁₂
haš₃	ha₅
baraₓ	bar₆
ut	u₄
tama	tam
had₂	ha₅
lah	la₇
zalaga	zalag
utu	ut
un₅	u₄
um₂	u₄
babar	bar₆
ul₆	u₄
ah₃	a₁₂
larsam₂	larsa₂
larsam	larsa
itaₓ	it₄
ed₂	e₃
edaₓ	ed₂
buranuna	buranun
buranunu	buranun
burununa	burunun
uhu₂	uh₂
keši₁₈	keš₁₈
adaba	adab
šaragₓ	šaraₓ
itud	itu
itid	iti
muruₓ	murₓ
murubₓ	muruₓ
murub₆	muru₁₃
muru₁₃	murₓ
itud₂	itu₂
itid₂	iti₂
udug	uduₓ
dihi₂	dih₂
tehi₂	teh₂
um	u₁₆
umu	um
dehi₂	deh₂
siu	si₇
umₓ	u₁₂
un	u₁₂
kalama	kalam
uŋ₃	u₁₂
uga₃	ug₃
unu₄	un
ug₃	u₁₂
ura	ur
taša	taš
liq	li₇
lig	li₇
uru₁₃	ur
lik	li₇
liki	lik
lirum₈	liru₈
uru₈	ur₂
urum₄	uruₓ
murum₄	muru₄
uru₇	ur₉
urum₂	uru₇
ura₄	ur₄
uru₁₉	ur₁₀
uri	ur₁₀
urimₓ	uri₃
urun	uru₃
urin	uri₃
ere	er₄
eri	er₄
ali	al₈
iri	ir₄
ala	al₈
ale	al₈
alu	al₈
urua	uru₁₈
šakira₃	šakir₃
urub	uru₁₁
gur₅	guₓ
šakiri	šakir
šakira	šakir
guruš₃	guru₅
guru₅	gur₅
asal	asaₓ
asari	asar
asar	asaₓ
asaru	asar
asara	asar
ulu₃⁻	ulu₃
ul₁₂	u₁₈
ulu₃	ul₁₂
lu₇⁻	lu₇
uru₁₇⁻	uru₁₇
šakiraₓ	šakirₓ
erim₆	eriₓ
urumₓ	uru₂
erin₆	eriₓ
banšura	banšur
uruda	urud
urudu	urud
dab₆	da₅
nintah	ninta
nitah	nita
nitahu	nitah
usa₂	us₂
nita	nit
usu₂	us₂
nintahu	nintah
ŋeštana₂	ŋeštan₂
ŋešdana₂	ŋešdan₂
gala	galₓ
ŋešdana₃	ŋešdan₃
ŋeštana₃	ŋeštan₃
uštug₂	uštu₂
uza₃	uz₃
uda₅	ud₅
širu	šir₄
šeru	šer₄
širim	širi₄
širum	širu
širi₄	šir₄
šuba₂	šub₈
šubuₓ	šub₈
zabalam₂	zabala₂
šuba	šub₇
zabalam	zabala
nira₃	nir₃
zag	za₃
zak	za₃
sak₆	saₓ
zaq	za₃
enkud	enku
zig₃	zi
zid	zi
ziqi	ziq
zubi	zub
zubu	zub
zub	zu₈
rik₂	ri₄
rig₂	ri₄
zum	zu₃
sum₂	su₁₄
ṣum	ṣu
rimₓ	ri₄
riq₂	ri₄
limu₅	limₓ
ia₂	i₂
aša₃	aš₃
nina₄	nin₅
nimina	nimin
nimin	nin₅
asilalₓ	asilaₓ
