šeŋ₃	šeg₃
esaŋ	esag
aŋarin	agarin
aŋarin₂	agarin₂
niŋin₆	nigin₆
alaŋ	alag
diŋir	digir
saŋtak	sagtak
saŋtak₃	sagtak₃
imŋaŋaₓ	imgagaₓ
imŋaŋa	imgaga
imŋaŋa₃	imgaga₃
imŋaŋa₂	imgaga₂
saŋmaš	sagmaš
balaŋ	balag
buluŋ₅	bulug₅
buluŋ	bulug
buluŋ₂	bulug₂
ŋarim₂	garim₂
ŋin	gin
ŋen	gen
ŋim₆	gim₆
giŋ₄	gim₂
aŋa₃	aga₃
niŋir	nigir
niŋir₂	nigir₂
ŋaₓ	maₓ
eŋar	egar
esaŋₓ	esagₓ
eŋaraₓ	egaraₓ
esaŋₓ	esagₓ
eŋer	eger
eŋir	egir
eŋera	egera
tunŋal₂	tungal₂
ŋeššir	geššir
ŋiššir	giššir
nimŋirŋirri₂	nimgirgirri₂
ŋer₁₅	ger₁₅
huŋ	hug
ŋe₇	ge₇
ŋir₁₅	gir₁₅
ŋi₇	gi₇
uŋ₅	ug₅
pisaŋ	pisag
ŋa₂	ga₂
bisaŋ	bisag
ŋe₂₆	ge₂₆
daŋal	dagal
aŋarin₃	agarin₃
aŋarin₄	agarin₄
aŋarin₅	agarin₅
ŋaiku	gaiku
ŋaburra	gaburra
ŋasikilla	gasikilla
ŋasibir	gasibir
eŋara	egara
ŋalga	galga
ŋagia	gagia
ŋaŋirsu	gagirsu
ŋahalla	gahalla
ŋahili	gahili
ŋalilla	galilla
ŋanun	ganun
esaŋ₂	esag₂
esaŋtur	esagtur
kindaŋal	kindagal
niŋ₂	nig₂
ŋar	gar
ŋar₃	gar₃
ŋeštin	geštin
ŋeština	geština
ŋiri₂	giri₂
ŋir₂	gir₂
ŋir₃	gir₃
ŋiri₃	giri₃
ŋiri₁₆	giri₁₆
ŋizal	gizal
ŋisal	gisal
ŋiš	giš
ŋiz	giz
ŋeš	geš
ŋissu	gissu
ŋištug₃	gištug₃
ŋeštug₃	geštug₃
ŋeštu₃	geštu₃
ŋištu₃	gištu₃
ŋištu₂	gištu₂
ŋeštug₂	geštug₂
ŋeštu₂	geštu₂
ŋištug₂	gištug₂
ŋizzal	gizzal
naŋa₄	naga₄
naŋ₄	nag₄
naŋa₃	naga₃
naŋ₃	nag₃
ŋuruš	guruš
ŋir	gir
ŋiri	giri
saŋŋar₂	saggar₂
ellaŋ₂	ellag₂
ŋal₂	gal₂
ŋeškim	geškim
aŋrig	agrig
ŋiškim	giškim
ŋiskim	giskim
ŋa₆	ga₆
šeŋ₇	šeg₇
šeŋₓ	šegₓ
šeŋₓ	šegₓ
šeŋ₁₄	šeg₁₄
aŋar₆	agar₆
aŋar₅	agar₅
naŋ	nag
šaŋar	šagar
ŋili₃	gili₃
ŋeli₃	geli₃
ŋiriₓ	giriₓ
ŋešbun₂	gešbun₂
ŋišbun	gišbun
ŋešbun	gešbun
uŋnim	ugnim
kiŋ₂	kig₂
nuŋun	numun
ellaŋ	ellag
niŋen₂	nimen₂
niŋi₂	nigi₂
niŋin₂	nigin₂
niŋen	nimenₓ
niŋin	nigin
ŋarin	garin
ŋarim	garim
saŋduduₓ	sagdudu
niŋin₁₁	nigin₁₁
niŋin₉	nigin₉
niŋinₓ	niginₓ
niŋin₅	nigin₅
niŋen₅	nimen
niŋin₈	nigin₈
šaŋaₓ	šagaₓ
šaŋa	šaga
saŋ₄	sag₄
eŋir₅	egir₅
ŋar₇	gar₇
saŋman	sagman
saŋmin	sagmin
ŋe₆	ge₆
ŋi₆	gi₆
ŋu₁₀	gu₁₀
ŋurgu₂	murgu₂
ŋur₂₄	mur₇
naŋa	naga
naŋar	nagar
šeŋ₆	šeg₆
iŋ₃	ig₃
aŋ₂	ag₂
eŋ₃	eg₃
saŋ₅	sag₅
zaŋ₃	zag₃
nesaŋ	nesag
nisaŋ	nisag
ŋišnu₂	gišnu₂
ŋešnu₂	gešnu₂
ŋalgaₓ	galgaₓ
aŋarŋara	agargara
luŋ₂	lug₂
ŋidru	gidru
ŋidri	gidri
ŋarzu	garzu
ŋarza	garza
hursaŋ	hursag
luŋa	luga
ŋarza₂	garza₂
buluŋ₃	bulug₃
ŋištug	gištug
ŋešdu	gešdu
ŋišdu	gišdu
ŋištu	gištu
ŋeštu	geštu
ŋeštug	geštug
piriŋa	piriga
uŋ₂	ug₂
piriŋ	pirig
piriŋ₃	pirig₃
ŋušur₂	gušur₂
ŋešpu	gešpu
ŋešbu	gešbu
ŋešpa	gešpa
ŋešba	gešba
saŋŋar	saggar
saŋ	sag
saŋdu	sagdu
saŋminₓ	sagminₓ
ŋal₄	gal₄
niŋ	nig
ŋidlam₄	gidlam₄
ŋidlam	gidlam
ŋitlam	gitlam
saŋŋa₇	sagga₆
ŋar₈	gar₈
ŋurgu	murgu
ŋišimmar	gišimmar
ŋišnimbar	gišnimbar
ŋešimmar	gešimmar
ŋešnimbar	gešnimbar
šeŋ₉	šeg₉
saŋ₅	sag₅
bisaŋ₂	bisag₂
nesaŋ₂	nesag₂
umbisaŋ	umbisag
aŋ₃	ag₃
nisaŋ₂	nisag₂
pisaŋ₂	pisag₂
saŋŋa	sagga
silaŋ	silag
umbisaŋ₂	umbisag₂
bisaŋ₃	bisag₃
pisaŋ₃	pisag₃
mezeŋ	mezeg
ŋešpu₂	gešpu₂
ŋešba₂	gešba₂
ŋešbu₂	gešbu₂
ŋalₓ	galₓ
ursaŋsim	ursagsim
teŋ₃	teg₃
ŋulla	gulla
tiŋ₄	tig₄
ŋeškadₓ	geškadₓ
ŋiškadₓ	giškadₓ
ŋešburₓ	gešburₓ
šaŋan	šagan
saŋšu	sagšu
saŋdul	sagdul
saŋₓ	sagₓ
niŋin₄	nigin₄
niŋ₆	nig₆
niŋar	nigar
niŋin₃	nigin₃
piriŋ₂	pirig₂
saŋuš	saguš
saŋus	sagus
kanaŋ	kanam
uŋ₃	ug₃
ŋišgal	gišgal
ŋiš₃	giš₃
ŋeš₃	geš₃
ŋitlam₂	gitlam₂
ŋidlam₂	gidlam₂
ŋidlam₃	gidlam₃
ŋitlam₃	gitlam₃
ŋeštae	geštae
gariŋ₂	garig
ŋeš₂	geš₂
ŋeš₂@c@v	geš₂@c@v
ŋiš₂	giš₂
ŋeš₂@c	geš₂@c
ŋešʾu	gešʾu
ŋešʾu@c	gešʾu@c
imŋaŋaₓ	imgagaₓ
ŋizzalₓ	gizzalₓ
